NO ./textures/NO.xpm
SO ./textures/SO.xpm
WE ./textures/WE.xpm
EA ./textures/EA.xpm

C 202, 165, 237
F 163, 207, 98

1111111
1010001
1010001
111N111
1111111